xxxxxxxxxxxxxxx
xp            x 
x x x x x x x x
x             x 
x x x x x x x x
x             x
x x x x x x x x
x             x
x x x x x x x x
x             x
x x x x x x x x
x            px
xxxxxxxxxxxxxxx


