xxxxxxxxxxxxxxx
xp      s     x 
x x x x x x x x
x   s    m    x 
x x x x x x x x
x    s   m s  x
x x x x x x x x
x    u        x
x x x x x xsxsx
x   m     sussx
x x x x xsxsx x
x        sss px
xxxxxxxxxxxxxxx


