xxxxxxxxxxxxxxxxx
xp              x 
x x x x x x x x x
x               x 
x x x x x x x x x
x               x
x x x x x x x x x
x               x
x x x x x x x x x
x               x
x x x x x x x x x
x              px
xxxxxxxxxxxxxxxxx


