xxxxxxxxxxxxxxx
xp      s     x 
x x x x xsx x x
x   s   sfs   x 
x x x x xsx x x
x    s     s  x
x x x x x x x x
x    u   f    x
x x x x x xsxsx
x    f    sussx
x x x x xsxsx x
x        sss px
xxxxxxxxxxxxxxx


