xxxxxxxxxxxxxxx
xp      s     x
x x x x xsx x x
x   s   sfs   x 
x x x x xsx x x
x    s   m s  x
x x x x x x x x
x    u   f    x
x x x x x xsxsx
x   m     sussx
x x x x xsxsx x
x   sfs  sss px
xxxxxxxxxxxxxxx


