xxxxxxxxxxxxxxx
xp      s     x 
x x x x x x x x
x   s         x 
x x x x x x x x
x    s     s  x
x x x x x x x x
x    u        x
x x x x x xsxsx
x         sussx
x x x x xsxsx x
x        sss px
xxxxxxxxxxxxxxx


