xxxxxxxxxxxxxxx
xp            x 
x x x x x x x x
x             x 
x x x x x x x x
x             x
x x x x x x x x
x    u        x
x x x x x x x x
x          u  x
x x x x x x x x
x            px
xxxxxxxxxxxxxxx


